R    0 0

NO ./images/brick.xpm
SO ./images/barrel.xpm
WE ./images/banner.xpm
EA ./images/blue.xpm
S ./images/hitler.xpm

F 220,100,0
C 225,30,5

        1111111111111111111111111
        1000000000110000000000001
        101100000111000000200000111
        101100000111000000200000111
        1001000000000000000000001
111111111011000001110000000000001
100000000011000001110111111111111
11110111111111011100000010001
11110111111111011101010010001
11000000110101011100000010001
10002000000000001100011110111
100000000000000011010100000011
1100000111010101111101100N00011
11110111 1110101 1011100000011
11111111 1111111 111111111111
